{
  "layout": [
    "_____________________",
    "_____________________",
    "_____________________",
    "_____/////_/////_____",
    "_____/___///___/_____",
    "_____/_#_/@/_#_/_____",
    "___/////C/X/C/////___",
    "___/_d_A_____B_d_/___",
    "___/_#_/a_?_b/_#_/___",
    "___/////#_!_#/////___",
    "___/_#_/a___b/_#_/___",
    "___/___B__#__A___/___",
    "___//////D/D//////___",
    "_______/__/__/_______",
    "_______/__/#_/_______",
    "_______/_#/c_/_______",
    "_______///////_______",
    "_____________________",
    "_____________________",
    "_____________________"
  ],
  "clock": 100,
  "levelNumber": 1
}