{
  "layout": [
    "//@///a/b#////b#/",
    "//X///c/__////__/",
    "/__///d/__////__/",
    "/B////b/__////__/",
    "/____/a/__////__/",
    "/__#_/c/__////__/",
    "/_#__/d/__////__/",
    "/____/b/__////__/",
    "//D/////D//////A/",
    "/_____//________/",
    "/_____//!_?#_a__/",
    "/__#__//________/",
    "/_____//B//////A/",
    "/_____//_#////__/",
    "///A////__////__/",
    "/______/__////__/",
    "/______/__////__/",
    "/__#a__C_a////__/",
    "/__d#__/_#////__/",
    "/______/__////_#/",
    "/______/__////_c/"
  ],
  "clock": 120,
  "levelNumber": 2,
  "helpText": [
    "Don't touch the monsters\nNote: to be added soon\n"
  ]
}